11
..#...#....
.##.#.#.##.
..#.#.#..#.
#.#.#.#.##.
..#.#.#.#..
S...#...#.G
..#.#.#.#..
#.#.#.#.##.
..#.#.#..#.
.##.#.#.##.
..#...#....
