11
...........
...#G......
...#####...
...........
...........
.......S...
...........
...........
...........
...........
...........
