10
S......#.#
#.####.#.#
#..##.....
##.##.##.#
......##..
##.##..###
#...##....
#.#.###.#.
..#..##.#.
#.##.....G
